#######
#.....#
#.###.#
#..X#.#
#.###.#
#.....#
#.##..#
#..##.#
##I#..#
#..#.##
#.I#..#
#######