#######
#.....#
#.###.#
#..X#.#
####..#
#.....#
####..#
##....#
##I#..#
#.I#.##
#.I#..#
#######