############
#.......#.##
#.###.#..#.#
#..X#......#
#.###.##.#.#
#..........#
#.P#...#.#.#
#..P#....#.#
##I#.......#
#....#...#.#
#H.#.....###
############
