###########
#.........#
#.........#
#..X......#
#.........#
#.........#
#.........#
#.........#
#.........#
#.........#
###########