#######
#.....#
#.###.#
#..X#.#
####PI#
#...II#
#.##..#
#..##.#
##.#..#
#..#.##
#..#..#
#######