#######
#.....#
#.###.#
#..X#.#
#####.#
#.....#
#.##..#
#...#.#
##I#..#
#.I#.##
#.I#..#
#######