###########
#.......#.#
#.###.....#
#..X#.###.#
####..#.#.#
#.....#.#.#
#.##.##.#.#
##........#
#.....#.#.#
##H.....###
###########