###########
#.......#.#
#.###.....#
#..X#.###.#
####..#.#.#
#.....#.#.#
#.##.##.#.#
##...P....#
###..P#.#.#
##H..P..###
###########