###########
#.......#.#
#.###.....#
#..X#.###.#
####..#.#.#
#.....#.#.#
#.##.##.#.#
##...P....#
###..##.#.#
##H..#..###
###########