###########
#.......#.#
#.#.#.....#
#..H#.#.#.#
##.#......#
#.....#.#.#
#.#.#...#.#
##........#
#.#..#..#.#
##X.....###
###########