###########
#.......#.#
#.###.....#
#..X#.#.#.#
####..#.#.#
#.....#.#.#
#.##.##.#.#
##...P....#
###..##.#.#
##H.....###
###########