###########
#.......#.#
#..#......#
#.X..#....#
#..#....#.#
#..#..#.#.#
#.#..#..#.#
##........#
###..##.#.#
##......#H#
###########