#######
#.....#
#.###.#
#..X#.#
#.###.#
#.....#
#.P#..#
#..P#.#
##I#..#
#..#.##
#.I#..#
#######