############
#I.........#
#..........#
#..........#
#..X.......#
#..........#
#..........#
#..........#
#..........#
#..........#
#..........#
############