#######
#.....#
#.###.#
#..X#.#
####..#
#.....#
####..#
##....#
##I#..#
#.I#.##
#.H#..#
#######