#######
#.....#
#.PPP.#
#..XP.#
#PPP..#
#.....#
#PPP..#
#P....#
#PIP..#
#.IP.##
#.IP..#
#######